7 8 12 5 27
CCVBBBBBB
VCVBBBBBB
VCVBBBBBB
VCVVVVVVV
VCCCCCCCV
VCCCCCCCV
VCCCCCCCC
