7 9 13 6 30
CCVBBBBBBB
VCVBBBBBBB
VCVBBBBBBB
VCVVVVVVVV
VCCCCCCCCV
VCCCCCCCCV
VCCCCCCCCC
