8 9 14 6 33
CCVBBBBBBBB
VCVBBBBBBBB
VCVBBBBBBBB
VCVVVVVVVVV
VCCCCCCCCCV
VCCCCCCCCCV
VCCCCCCCCCC
