9 10 18 7 41
CCVBBBBBBBBBB
VCVBBBBBBBBBB
VCVBBBBBBBBBB
VCVVVVVVVVVVV
VCCCCCCCCCCCC
VCCCCCCCCCCCC
VCCCCCCCCCCCC
