8 10 16 7 38
CCVBBBBBBBBB
VCVBBBBBBBBB
VCVBBBBBBBBB
VCVVVVVVVVVV
VCCCCCCCCCCC
VCCCCCCCCCCC
VCCCCCCCCCCC
