6 8 10 5 24
CCVBBBBB
VCVBBBBB
VCVBBBBB
VCVVVVVV
VCCCCCCV
VCCCCCCV
VCCCCCCC
